


















 ###################################
 #~~~~~~~~~~~~~~~~~~~~~~~~~~~~~~~~~#
 #~~~~~~~~~~~~~~~~~~~~~~~~~~~~~~~~~#
 #~~~~~~~~~~~~~~~~~~~~~~~~~~~~~~~~~#
 ~~~~~~~~~~~~~~~~~~~~~~~~~~~~~~~~~~#
 ~~~~~~~~~~~~~~~~~~~~~~~~~~~~~~~~~~#
 ~~~~~~~~~~~~~~~~~~~~~~~~~~~~~~~~~~#
 ~~~~~~~~~~~~~~~~~~~~~~~~~~~~~~~~~~#
 ~~~~~~~~~~~~~~~~~~~~~~~~~~~~~~~~~~#
 #~~~~~~~~~~~~~~~~~~~~~~~~~~~~~~~~~#
 #~~~~~~~~~~~~~~~~~~~~~~~~~~~~~~~~~#
 #~~~~~~~~~~~~~~~~~~~~~~~~~~~~~~~~~#
 ###################################
