 
 
 
 
 
 
 
 
 
 ###################################
 #~~~~~~~~~~~~~~~~~~~~~~~~~~~~~~~~~#
 #~~~~~~~~~~~~~~~~~~~~~~~~~~~~~~~~~#
 #~~~~~~~~~~~~~~~~~~~~~~~~~~~e~~~~~#
 ~~~~~~~~~~~~~~~~~~~~~~~~~~~~~~~~~~#
 ~~~~~~~~~~~~~~~~~~~~~~~~~~~~~~~~~~#
 ~~~~~~~~~e~~~~~~~~~~~~~~~~~~~~~~~~#
 ~~~~~~~~~~~~~~~~~~~~~~~~~~~~~~~~~~#
 ~~~~~~~~~~~~~~~~~~~~~~~~~~~~~~~~~~#
 #~~~~~~~~~~~~~~~~~~~~~~e~~~~~~~~~~#
 #~~~~~~~~~~~~~~~~~~~~~~~~~~~~~~~~~#
 #~~~~~~~~~~~~~~~~~~~~~~~~~~~~~~~~~#
 ###################################
