 
 
 
 


 #########################################
 #~~~~~~~~~~~~~~~~~~~~~~#~~~~~~~~~~~~~~~~#
 #~~~~~~~~~~~~~~~~~~~~~~#~~~~~~~~~~~~~~~~########################
 #~~~~~~~~~~~~~~~~~~~~~~~~~~~~~~~~~~~~~~~~~~~~~~~~~~~~~~~~~~~~~~#
 #~~~~~~e~~~~~~~~~~~~~~~~~~~~~~~~~~~~~~~~~~~~~~~~~~~~~~~~~~~~~~~#
 #~~~~~~~~~~~~~~~~~~~~~~~~~~~~~~~~~~~~~~~~~~~~~~e~~~~~~~~~~~~~~~#
 #~~~~~~~~~~~~~~~~~~~~~~~~~~~~~~~~~~~~~~~~~~~~~~~~~~~~~~~~~~~~~~#
 #~~~~~~~~~~~~~~~~~~~~~~#~~~~~~~~~~~~~~~~########################
 #~~~~~~~~~~~~~~~~~~~~~~#~~~~~~~~~~~~~~~~#                 
 ############~~~~~########################                 
            #~~~~~#
            #~~~~~#
            #~~e~~#
            #~~~~~#
      #######~~~~~#######
      #~~~~~~~~~~~~~~~~~#
      #~~~~~~~~~~~~~~~~~#          
      #~~~~~~~~~~~~~~~~~#          
      #~~~~~~~~s~~~~~~~~#         
      #~~~~~~~~~~~~~~~~~#          
      #~~~~~~~~~~~~~~~~~#                            
      ###################                             
