 
 
 
 


 #########################################
 #~~~~~~~~~~~~~~~~~~~~~~#~~~~~~~~~~~~~~~~#
 #~~~~~~~~~~~~~~~~~~~~~~#~~~~~~~~e~~~~~~~########################
 #~~~~~~~~~~~~~~~~~~~~~~~~~~~~~~~~~~~~~~~~~~~~~~~~~~~~~~~~~~~~~~#
 #~~~~~~~~e~~~~~~~~~~~~~~~~~~~~~~~~~~~~~~~~~~~~~~~~~~~~~~~~~~~~~#
 #~~~~~~~~~~~~~~~~~~~~~~~~~~~~~~~~~~~~~~~~~~~~~~~~~~~~~~~~~~~~~~#
 #~~~~~~~~~~~~~~~~~~~~~~~~~~~~~~~~~~~~~~~~~~~~~~~~~~~~~~~~~~~~~~#
 #~~~~~~~~~~~~~~~~~~~~~~#~~~~~~~~~~~~~~~~###################~~~~#
 #~~~~~~~~~~~~~~~~~~~~~~#~~~~~~~~~~~~~~~~#                 #~~~~#
 ############~~~~~##################~~~~~#                 #~~~~#
            #~~~~~#                #~~~~~#            ######~~~~################
            #~~~~~#                #~~~~~#            #~~~~~~~~~~~~~~~~~~~~~~~~#
            #~~~~~#                #~~~~~#            #~~~~~~~~~~~~~~~~~~~~~~~~#
            #~~~~~#                #~~~~~#            #~~~~~~~~~~~~~~~~~~~~~~~~#
      #######~~~~~#######          #~~~~~##############~~~~~~~~~~~~~~~~~~~~~~~~#
      #~~~~~~~~~~~~~~~~~#          #~~~~~~~~~~~~~~~~~~~~~~~~~~~~~~~~~~~~~~~~~~~#
      #~~~~~~~~~~~~~~~~~#          #~~~~~~~~~~~~~~~~~~~~~~~~~~~~~~~~~~~~~~~~~~~#
      #~~~~~~~~~~~~~~~~~#          #~~~~~~~~~~~~~~~~~~~~~~~~~~~~~~~~~~~~~~~~~~~#
      #~~~~~~~~s~~~~~~~~#          #~~~~~~~~~~~~~~~~~~~~~~~~~~~~~~~~~~~~~~~~~~~#
      #~~~~~~~~~~~~~~~~~#          ####################~~~~~~~~~~~~~~~~~~~~~~~~#
      #~~~~~~~~~~~~~~~~~#                             #~~~~~~~~~~~~~~~~~~~~~~~~#
      ###################                             #~~~~~~~~~~~~~~~~~~~~~~~~#
                                                      #~~~~~~~~~~~~~~~~~~~~~~~~#
                                                      ##########################
